1111111111111111111111111111
1CCCCCCCCCCCC11CCCCCCCCCCCC1
1C1111C11111C11C11111C1111C1
1C1001C10001C11C10001C1001C1
1C1111C11111C11C11111C1111C1
1CCCCCCCCCCCCCCCCCCCCCCCCCC1
1C1111C11C11111111C11C1111C1
1C1111C11C11111111C11C1111C1
1CCCCCC11CCCC11CCCC11CCCCCC1
111111C11111C11C11111C111111
000001C11111C11C11111C100000
000001C11000000000011C100000
000001C11011111111011C100000
000001C11010000001011C100000
000001C00010000001000C100000
000001C11010000001011C100000
000001C11011111111011C100000
000001C11000000000011C100000
000001C11011111111011C100000
111111C11011111111011C111111
1CCCCCCCCCCCC11CCCCCCCCCCCC1
1C1111C11111C11C11111C1111C1
1C1111C11111C11C11111C1111C1
1CCC11CCCCCCCCPCCCCCCC11CCC1
111C11C11C11111111C11C11C111
111C11C11C11111111C11C11C111
1CCCCCC11CCCC11CCCC11CCCCCC1
1C1111111111C11C1111111111C1
1C1111111111C11C1111111111C1
1CCCCCCCCCCCCCCCCCCCCCCCCCC1
1111111111111111111111111111